XXXXXXXXWWWWWX
XXXWWWWWWOOOWX
XXXWOOOWWOOOWX
XXXWOOOWWOOOWX
XXXWDDDWWOOOWX
XXWWOOOWWWOWWX
XWWOOOOWWWDWWW
WWOOOOOWOOOOOW
WOOOOOOWOOOOOW
WOOOOOODOOOOOW
WOOOOOODOOOOOW
WOOOOOOWOOOOOW
WOOOOOOWOOOOOW
WOOOOOOWOOOOOW
WOOOOOOWWOOWWW
WWWWWWWWWOOWXX
XXXXXXXXWOOWXX
XXXXXXXXWOOWXX
XXXXXXXXWOOWXX