XXXXXWWWWWWWWWXXXXX
XXXXXWOOOOOOOWXXXXX
XXXXXWOOOOPOOWXXXXX
XXXXXWOOEOOOOWXXXXX
XXXXXWWWOOOWWWXXXXX
XXXXXWOOOOOOOWXXXXX
XXXWWWOWWWWWOWWWXXX
WWWWOOOOOWOOOOOWWWW
WOOWOOOOOWOOOOOWOOW
WOOOOOOOOWOOOOOOOOW
WOOWOOOOOWOOOOOWOOW
WWWWOOOOOWOOOOOWWWW
XXXWWWOWWWWWOWWWXXX
XXXXXWOWOOOWOWXXXXX
XXXXXWOOOOOOOWXXXXX
XXXXXWWWOOOWWWXXXXX
XXXXXXXWWWWWXXXXXXX