WWWWXWWWWWWWW
WOOWWOWOOOOOW
WOOWOOOOOOOOW
WOOWWOWOOOOOW
WOOOWOOOOOOOW
WOOOOOWOOOOOW
WOOOWWWOOOOOW
WOOOWOWOOOOOW
WOOOWOOOOOOOW
WOOOWWWWWWDWW
WOOODOOODOOOW
WWOOWOOOWOOOW
XWWWWWWWWWWWW