OOOOOOOOO
OOOOOOOOO
OOOOOOOOO
OOOOWOOOO
OOOWWWOOO
OOOOWOOOO
OOOOOOOOO
OOOOOOOOO
OOOOOOOOO